10 10 1 2
1 1 12 1 1 1 1 1 1 1
1 1 6 6 1 1 6 6 1 1
11 9 5 1 1 1 1 5 7 1
1 9 1 1 1 1 1 1 7 1
1 1 1 1 1 1 1 1 1 1
1 1 1 1 1 1 1 1 1 1
1 9 1 1 1 1 1 1 7 1
1 9 5 1 1 1 1 5 7 13
1 1 8 8 1 1 8 8 1 1
1 1 1 1 1 1 1 14 1 1/

10 10 1 2
12 12 12 12 12 12 12 12 12 13
11 1 1 6 6 6 6 1 1 13
11 1 1 1 1 1 1 1 1 13
11 9 1 1 1 1 1 1 7 13
11 9 1 1 1 1 1 1 7 13
11 9 1 1 1 1 1 1 7 13
11 9 1 1 1 1 1 1 7 13
11 1 1 1 1 1 1 1 1 13
11 1 1 8 8 8 8 1 1 13
11 14 14 14 14 14 14 14 14 14/

10 10 2 50
1 1 12 1 1 1 1 1 1 1
1 1 6 6 1 1 6 6 1 1
11 9 5 1 1 1 1 5 7 1
1 9 1 1 5 1 1 1 7 1
1 1 1 1 11 13 5 1 1 1
1 1 1 5 11 13 1 1 1 1
1 9 1 1 1 5 1 1 7 1
1 9 5 1 1 1 1 5 7 13
1 1 8 8 1 1 8 8 1 1
1 1 1 1 1 1 1 14 1 1/