
4 4 1 2
1 1 1 1
1 1 1 1
1 1 1 1
1 1 1 1/

5 5 1 2
4 4 4 4 4
4 1 1 1 4
4 1 1 1 4
4 1 1 1 4
4 4 4 4 4/

4 4 1 2
1 1 1 1
1 13 1 1
1 1 11 1
1 1 1 1/

4 4 1 2
1 1 1 1
1 5 1 1
1 1 5 1
1 1 1 1/

5 4 1 2
1 1 1 1 1
1 1 8 1 1
1 1 6 1 1
1 1 1 1 1/

4 4 1 2
1 1 1 1
1 1 1 1
1 1 1 1
1 1 1 1/

4 5 1 2
1 1 1 1
1 2 2 1
1 2 2 1
1 2 2 1
1 1 1 1/

4 5 2 5 
1 1 1 1
1 1 8 1
1 1 1 1
1 6 1 1
1 1 1 1/

5 5 2 4
1 1 1 1 1
1 10 1 10 1
1 1 1 1 1
1 10 1 10 1
1 1 1 1 1/

4 4 3 4
1 1 1 1
1 5 1 1
1 1 5 1
1 1 1 1/

6 6 3 4
1 12 1 1 13 1
1 11 1 1 13 1
1 11 1 1 13 1
1 11 1 1 13 1
1 11 1 1 13 1
1 11 1 1 14 1/

5 5 3 6
1 1 1 1 1
1 12 12 13 1
1 11 1 13 1
1 11 14 14 1
1 1 1 1 1/

6 6 4 6
1 1 1 1 8 1
7 6 1 1 7 1
1 1 1 1 1 1
1 1 1 1 1 1
1 9 1 1 8 9
1 8 1 1 1 1/

6 6 7 100
1 1 1 1 1 1
1 1 1 1 1 1
1 1 1 1 1 1
1 1 1 1 1 1
1 1 1 1 1 1
1 1 1 1 1 1/